R 1020 510
NO ./textur/greystone.xpm
SO ./textur/wood.xpm
WE ./textur/bluestone.xpm
EA ./textur/redbrick.xpm

S ./textur/Shrek__character_.xpm
F 220,100,0
C 245,99,142
			

        1111111111 11111111111111
        1000020001110000000000001
        1011000001110000000000001
        10010002000000000W0000001
111111111011000001110000000000001
100000000011020001110111111111111
11110111111111011100000010001
11110111111111011101010010001
11111111111111111111111111111
11111111111111111111111111111
11000000111101011100000010001
100000001 1000001100000000001
100000001 1000001101010010001
1100000111110101111101101000111
11110111 1110101 101111110001
11111111 1111111 111111 11111
