R 1920 1080
NO ./textur/redbrick.xpm
SO ./textur/wood_1.xpm
WE ./textur/greystone.xpm


EA ./textur/bluestone_1.xpm
S ./path_to_the_sprite_texture
F 161,123,175
C 239,237,153

111111111111111111111111111111111
100000000000000000000100000000001
10000000000000000N0001000000000011111
1000000000000000000001000000000000001
1000000000000000000001000000000000001
1000000011111100000000000000000000001
100000001000010000000000000000000000111111
100000001111110000000000000000000000000001
100000000000000000000000000000000000000001
100000000000000000000000000000000000000001
100000000000000000000000000000000000000001
111111111111111111111111111111111111111111
