111111111111111111111
100000000000000000001
100000000000000000001
100000000000000000001
100000000000000000001
10000000N00000000000111111111111111
10000000000000000000000000000000001
10000000000000000000000000000000001
10000000000000000000000000000000001
10000000000000000000000000000000001
10000000000000011100000000000000001
10000000000000010100000000000000001
10000000000000011100000000000000001
10000000000000000000000000000000001
10000000000000000000000000000000001
10000000000000000000000000000000001
11111111111111111111111111111111111
