


R 900   500

NO      ./textur/greystone.xpm

     SO ./textur/wood.xpm

WE ./textur/bluestone.xpm

EA ./textur/redbrick.xpm  

     S    ./textur/barrel.xpm

F    220,  100,0  

C 245,   99  ,142


    1111111111111111111
    11000000000000000011
    111000000000000000011
    11000000100000000001
    111000000000000000011
1111110000000000000000001
1100000000000011111111111111
1100010000N00000000200000001
1100000000000000001111111011
100000000000000000111211101
100000000000000000011011101
110000000000000000001000001
11000000000000000001111111111111
11000000000000000000000000000001
10000000212000000001111111111111
11111111212111111111
11111111111111111111
